22222222222222222222
20000011111002000012
20000010100011020002
21020020111000000002
22110000000000020012
20010000011102200012
20020000001102010012
20020022000201002012
20010000010001020012
20001020000000001112
20000010220001100002
20001010010001111112
20001010110000010012
20001000110001000102
21111000110001001002
21112000020001010002
20011222210010211012
21122000110100001002
20000101000100001112
22222222222222222222