22222222222222222222
21000000011002000012
20020000100011020002
20000000111000000002
20110100101000020012
20010020011102200012
20020000001102010012
20020020000201002012
20010000010001020012
20001020100000001112
20000010110001100002
20001110110001111112
20001110110000010012
20001100110001000102
21111100110001001002
21112000020001010002
20011222210010211012
21122000110100001002
20000101000100001112
22222222222222222222
>>>>>>> dev_justine_3
