2222222222
2000000002
2002002002
2000000002
2000001002
2000000002
2002000002
2002002002
2001002002
2222222222